##       B     #
## ## ##########
#  #  #        #
# ## #  ###### #
#  	    	   #
# ###    ##    #
#      ## A    #
################
