##       B     #
## ## ##########
#  #  #        #
# ## #  ###### #
#              #
# ###    ##    #
#      ## A    #
################