####################
# B          # # # #
# # #  ##          #
#     #     #####  #
# #####  #####     #
#           ###    #
### # #  #      #  #
#     #          A #
####################