## B           #
## ## ##########
#  #  #        #
# ## #  ###### #
#        ##    #
#      ## A    #
################
